........b...............
........b.........................................................................g.g...........................................................................................................77.................
........b.........................................................................22222222...222s...............s...........222....2ss2........................................................777.................
........b................s....................................................................................................................................................................7777.................
........b....................................................................................................................................................................................77777.................
........b...................................................................................................................................................................................777777.............111.
........b..........s...2s2s2......................45........45.................2s2...............2.....22....s..s..s.....2..........22......7..7..........77..7............................7777777.............111.
........b................................45.......36........36.............................................................................77..77........777..77...........22s2...........77777777............11111
........b......................45........36.......36........36............................................................................777..777......7777..777.....45..............45.777777777........f...11111
........b..+...................36........36g......36...g.g..36......................................g.g.......k......g.g.....g.g..g.g....7777..7777....77777..7777....36........g.g...367777777777........7...11111
111111111111111111111111111111111111111111111111111111111111111111111111..111111111111111...1111111111111111111111111111111111111111111111111111111111111111..1111111111111111111111111111111111111111111111111111111111111
111111111111111111111111111111111111111111111111111111111111111111111111..111111111111111...1111111111111111111111111111111111111111111111111111111111111111..1111111111111111111111111111111111111111111111111111111111111
111111111111111111111111111111111111111111111111111111111111111111111111//111111111111111///1111111111111111111111111111111111111111111111111111111111111111//1111111111111111111111111111111111111111111111111111111111111
